9 9
1 1 0 0 0 0 0 0 0
1 1 0 0 0 0 0 0 0
1 1 1 1 1 1 1 1 0
1 1 0 0 0 0 0 0 0
1 1 0 1 1 1 1 1 0
1 1 0 1 1 1 1 1 0
1 1 0 1 1 1 0 0 0
1 1 0 1 1 1 0 0 0
0 0 0 0 0 0 0 0 0


3:4B:true:0:600:80:680:blue:0
3:4A:true:240:560:320:640:blue:0


