9 9
0 0 0 0 0 0 0 0 0
0 0 0  0 0 0 0 0
0 0 1 1 1 4 1 1 0
0 0 1 1 1 4 1 1 0
0 0 1 1 1 4 1 1 0
0 0 1 1 1 4 1 1 0
0 0 1 1 1 4 1 1 0
0 0 1 1 1 4 1 1 0
0 0 0 0 0 0 0 0 0

3:1:true:320:160:400:240:blue:0
J:1:true:480:360:560:440:black:0