9 9
0 0 0 0 0 0 0 0 0
0 0 0 0 0 0 0 0 0
0 0 1 1 1 1 1 1 0
0 0 1 1 1 0 1 1 0
0 0 1 1 0 0 1 1 0
0 0 1 1 1 1 1 1 0
0 0 1 1 1 1 1 1 0
0 0 1 1 1 1 1 1 0
0 0 0 0 0 0 0 0 0

3:0:true:360:640:440:720:blue:0
3:2:true:360:0:440:80:blue:0
F:0:true:360:80:440:160:grey:0