9 9
0 1 1 0 0 0 0 0 0
0 1 1 0 0 0 0 0 0
0 1 1 1 1 1 1 1 1
0 1 1 0 0 0 0 0 0
0 1 1 0 1 1 1 1 1
0 1 1 0 1 1 1 1 1
0 1 1 0 1 1 1 0 0
0 1 1 0 1 1 1 0 0
0 0 0 0 0 0 0 0 0


3:3A:true:80:560:160:640:blue:0
3:3B:true:320:560:400:640:blue:0


